1111111111111
100100000C001
100K0111110k1
10001EP000001
1000000000001
1111111111111
