1111111111111
100100000C001
10K0011111k01
10001EP000001
1000000000101
1111111111111
