1111111111111
100100000C101
101K111111k11
10011EP000101
1000000000101
1111111111111
