1111111111111
1001000000C01
1000011111001
10011EP000001
1111111111111
