1111111111111
100100000C101
110K111110k01
10001EP000001
1000000000101
1111111111111
